Grapheme	IPA
q	q
a	a
b	b
=	ɨ
k	k
u	u
p	p
%	ɔ
i	i
o	o
G	G
V	ā
x	x
\\	ə
v	v
r	r
n	n
e	e
m	m
d	d
Q	ü
S	δ
j	j
z	z
P	ö
^	ɘ
K	ǖ
H	š
s	s
t	t
@	ī
c	c
&	ɛ
W	ē
g	g
M	ä
X	ǟ
*	ɣ
A	ś
~	č
Z	ǯ
J	ž
U	ŋ
E	χ
l	l
1	ɘʷ
F	ū
w	w
T	ō
h	h
5	ẹ
7	ụ
6	ọ
2	əʷ
8	ď
f	f
$	ɨ̄
9	ń
!	ȫ
C	ź
D	ǚ
4	ŭ
G	ɢ
